0000222220000000000
0000200020000000000
0000230020000000000
0022200322000000000
0020030302000000000
2220202202000222222
2000202202222200442
2030030000000000442
2222202220212200442
0000200000222222222
0000222222200000000