2222222222
2403000002
2000000002
2000000002
2000103042
2030000002
2000020002
2040020002
2000000002
2222222222